DOOOOXXXXXXXXXX
XXXXOXXXXOOOOOX
XOXXOOOXXOXOXXX
XOXXOXOOOOXOXXX
XOOOOXOXOXXOOOX
XXXOXXOXOXXOXOX
XXXOXXOXXXXOXOX
XXXOOOOXOOOOXOX
XOOOOXXXOXOXXXX
XOXOXXXXOXOXXOX
XOXOXOOOOXOOOOX
XOXOXXXXXXXXXXX
XXXOXXXOOOOXXXX
XXXOOOOOXXXXOOB
XXXXXOXOOOOOOXA
